Inputs
Column ->
Row v

Stage 1 Input
64 63 62 61 60 59 58 57
56 55 54 53 52 51 50 49
48 47 46 45 44 43 42 41
40 39 38 37 36 35 34 33
32 31 30 29 28 27 26 25
24 23 22 21 20 19 18 17
16 15 14 13 12 11 10 9
8 7 6 5 4 3 2 1

<<All Ascending>>

Stage 1 Output
57 58 59 60 61 62 63 64
49 50 51 52 53 54 55 56
41 42 43 44 45 46 47 48
33 34 35 36 37 38 39 40
25 26 27 28 29 30 31 32
17 18 19 20 21 22 23 24
9 10 11 12 13 14 15 16
1 2 3 4 5 6 7 8

<<Transpose>>

Stage 2 Input
57 49 41 33 25 17 9 1
58 50 42 34 26 18 10 2
59 51 43 35 27 19 11 3
60 52 44 36 28 20 12 4
61 53 45 37 29 21 13 5
62 54 46 38 30 22 14 6
63 55 47 39 31 23 15 7
64 56 48 40 32 24 16 8

<<Alternate ascending and descending>>

Stage 2 Output

1 9 17 25 33 41 49 57
58 50 42 34 26 18 10 2
3 11 19 27 35 43 51 59
60 52 44 36 28 20 12 4
5 13 21 29 37 45 53 61
62 54 46 38 30 22 14 6
7 15 23 31 39 47 55 63
64 56 48 40 32 24 16 8

<<Transpose>>


Stage 3 Inputs

1 58 3 60 5 62 7 64
9 50 11 52 13 54 15 56
17 42 19 44 21 46 23 48
25 34 27 36 29 38 31 40
33 26 35 28 37 30 39 32
41 18 43 20 45 22 47 24
49 10 51 12 53 14 55 16
57 2 59 4 61 6 63 8

<<All Ascending>>

Stage 3 Outputs

1 3 5 7 58 60 62 64
9 11 13 15 50 52 54 56
17 19 21 23 42 44 46 48
25 27 29 31 34 36 38 40
26 28 30 32 33 35 37 39
18 20 22 24 41 43 45 47
10 12 14 16 49 51 53 55
2 4 6 8 57 59 61 63

<<Transpose>>

Stage 4 Input

1 9 17 25 26 18 10 2
3 11 19 27 28 20 12 4
5 13 21 29 30 22 14 6
7 15 23 31 32 24 16 8
58 50 42 34 33 41 49 57
60 52 44 36 35 43 51 59
62 54 46 38 37 45 53 61
64 56 48 40 39 47 55 63

<< Alternate descending and ascending >>

Stage 4 Output

26 25 18 17 10 9 2 1
3 4 11 12 19 20 27 28
30 29 22 21 14 13 6 5
7 8 15 16 23 24 31 32
58 57 50 49 42 41 34 33
35 36 43 44 51 52 59 60
62 61 54 53 46 45 38 37
39 40 47 48 55 56 63 64

<<Transpose>>

Stage 5 Input

